braces - фигурные скобки {}
even - даже, как раз, ровный
associated - связанный
other - другой, остальные
below - ниже, внизу
access - доступ, подход
direct - прямой, прямо, наводить
concatenate - сцеплять, связывать
exercise - упражнение, тренировка
over - над, через, свыше
loop - петля, виток, спираль
unordered - неупорядоченный
guarantee - гарантия
through - через, сквозь
each other - друг с другом
to each other - друг другу
equal - равный, равносильный
proud owner - гордый владелец
entries - записи
along - вместе, вдоль
multiply - умножить
purchase - покупка
note - внимание, примечание, записка
billing - выручка
until - до тех пор
decimal - десятичные
include - включают, содержат
grade - класс, оценкa
average - средний, нормальный
divine - божественный, угадывать
divide - делить, поделить
define - определять, устанавливать значение
weight - вес, весить
compute - вычислять
contains - содержит
considered - считается
rather - скорее, лучше
indent - отступ, абзац
parentheses - скобки
colon - двоеточие
iterate throught - перебирать
separator - разделитель
row - строка
valid - действительный
desired - желательный
got the hang of it - понял это
the hang of it - суть этого
kind - добрый, вид, разновидность, семейство и т.п.
fill - заполнение, заполнять, набивать
decrement - декремент, уменьшение, убыль
instead - вместе, взамен
comma - запятая
consider - подумать, рассматривать, обдумывать
virtual environment - виртуальное окружение
south - юг
north - север
west - запад
east - восток
approved - одобренный, испытанный
in a row - подряд, в ряд
inerits - наследуется, перенять, унаследовать
templates - шаблон
include - включая
layout - макет, схема, план, разметка
common - общее, обычный, общепринятый
allows - позволяет, допускать, разрешать
signature - подпись, автограф, подписание
asterisk - звездочка, знак сноски
behavior - поведение, режим, поступки
dry - сухой
wet - мокрый
accurate - точный
inaccurate - неточный
shallow - мелкий, не глубокий
cheerful - веселый
gloomy - мрачный
reasonable - разумный
sensible - здравый
cautious - осторожный
careless - беспечный
excited - взволнованный
confident - смелый, уверенный
timid - робкий
shy - застенчивый
spy - шпион
tasteless - безвкусный
ugly - уродливый, безобразный
decent - приличный, порядочный
obscene - непристойный
disloyal - предательский, нелояльный
kind - добрый
kinds - тип, вид
dull - тусклый
colorless - бесцветный
sharp - острый
union - союз, объединение, соединение
desire - желание, cтрасть
destiny - судьба
dissent - разногласие, несогласие
wicked - злой, грешный, безнравственный
smooth - гладкий, плавный
extended - распространение, продленный, вытянутый
duct - проток, канал, трубопровод
silly - глупый, простой, глуповатый
how dare you - как ты смеешь
dare - сметь, посметь, дерзать
garbage - мусор, отбросы, чушь
flattened - сплющенный, сплюснутый
flat - плоский, ровный
strip - полоса, лента, планка
font - шрифт
either - или, любой, другой
vice versa - наоборот, обратно
fine - хорошо, прекрасно
the fine - штраф
submit - отправить, подавать, подчиняться
feeble - слабый, немощный, хилый
article - статья, изделие, вещь
computation - вычисление, расчет
calculus - исчисление, камень, конкремент
tremble - дрожать, дрожь, трястись
savage - дикарь, невоспитанный, жестокий
ravage - опустошение, разорение, уничтожение
slave - раб
slaver - работорговец, слюни, грубая лесть
slayer - убийца
ashes - пепел
liquid - жидкость, жидкий
smooth - гладкий, плавный
spades - пики(масть)
clubs - трефы(масть)
hearts - черви(масть)
diams - бубны(масть)
sample - образец, пример
extended - расширенный, вытянутый, пробленный
extensible - растяжимый
scrany - тощий, костлявый
to pass - передать, проходить
instead - вместо, взамен
above - выше, ранее
